1111111111111
1A010000000E1
1000011101111
10P011C000001
1111111111111